[
    "11111111111111111111111111111111111111111111",
    "11111111111111111110000011111111111111111111",
    "11111111111111110000000000111111111111111111",
    "11111111111111100000000000001111111111111111",
    "11111111111111000000000000000111111111111111",
    "11111111111110000000000000000111111111111111",
    "11111111111110000000000000000011111111111111",
    "11111111111110000000111000000011111111111111",
    "11111111111100000001111100000001111111111111",
    "11111111111100000011111110000001111111111111",
    "11111111111100000011111110000001111111111111",
    "11111111111100000011111110000001111111111111",
    "11111111111100000011001110000001111111111111",
    "11111111111100000011000110000001111111111111",
    "11111111111100000011000110000001111111111111",
    "11111111111100000011000110000001111111111111",
    "11111111111100000011000110000001111111111111",
    "11111111111100000011000110000001111111111111",
    "11111111111100000011000110000001111111111111",
    "11111111111100000011000110000001111111111111",
    "11111111111100000011000110000001111111111111",
    "11111111111100000011000110000001111111111111",
    "11111111111100000011000110000001111111111111",
    "11111111111100000011000110000001111111111111",
    "11111111111000000011000110000000111111111111",
    "11111111111000000011000110000000111111111111",
    "11111111110000000111000110000000011111111111",
    "11111111110000001111000111000000011111111111",
    "11111111100000001110000111100000011111111111",
    "11111111100000011100000011100000001111111111",
    "11111111100000011100000001110000001111111111",
    "11111111100000011100000001110000001111111111",
    "11111111100000011100000001110000001111111111",
    "11111111100000011100000001100000001111111111",
    "11111111100000001110000011100000011111111111",
    "11111111110000000111111111000000011111111111",
    "11111111110000000011111110000000011111111111",
    "11111111111000000001111000000000111111111111",
    "11111111111000000000000000000000111111111111",
    "11111111111100000000000000000001111111111111",
    "11111111111110000000000000000011111111111111",
    "11111111111111000000000000000111111111111111",
    "11111111111111110000000000011111111111111111",
    "11111111111111111110000011111111111111111111"
]